+---+---+---+---+---+---+---+---+---+---+---+---+---+---+---+---+
|       |                   |       |       |                   |
+   +   +   +---+---+   +---+   +   +   +   +   +---+---+---+   +
|   |       |       |   |       |       |   |   |               |
+   +---+---+   +   +   +   +---+---+   +   +   +   +---+---+---+
|   |           |       |       |       |   |   |   |           |
+   +   +---+---+---+---+---+   +   +   +   +   +   +---+   +   +
|   |   |                       |   |           |   |   |   |   |
+   +   +   +---+---+---+---+---+---+   +---+---+   +   +   +   +
|   |   |       |       |       |       |       |       |   |   |
+   +   +   +   +   +   +   +   +   +   +   +   +   +   +   +   +
|   |       |       |       |       |       |       |       |   |
+   +   +---+---+---+---+---+   +---+---+---+---+---+---+---+   +
|   |   |       |           |       |   |   |   |   |           |
+   +   +   +   +   +---+   +---+---+   +   +   +   +   +---+   +
|   |   |   |   |   |       |                               |   |
+   +   +   +   +   +   +---+   +   +   +   +   +   +   +---+   +
|   |   |   |   |   |       |       |   |   |   |   |           |
+   +   +   +   +   +   +   +---+---+---+---+---+---+---+   +---+
|   |   |   |   |   |   |                                       |
+   +   +   +   +   +---+---+---+---+---+---+---+---+---+---+   +
|   |   |   |       |       |       |       |       |       |   |
+   +   +   +---+---+   +   +   +   +   +   +   +   +   +   +   +
|   |   |               |       |       |       |       |       |
+   +   +---+---+   +---+---+---+---+---+---+---+---+---+---+---+
|   |               |   |                               |       |
+   +   +---+   +---+   +   +---+---+---+---+---+---+   +---+   +
|   |       |               |                           |       |
+   +---+   +---+---+---+---+   +---+   +---+   +---+---+   +   +
|       |                       |   |                       |   |
+   +   +---+---+---+---+---+---+   +---+---+---+---+---+---+   +
|   |                                                           |
+---+---+---+---+---+---+---+---+---+---+---+---+---+---+---+---+
