+---+---+---+---+---+---+---+---+---+---+---+---+---+---+---+---+
|           |                   |           |   |   |   |   |   |
+   +---+   +   +---+---+---+   +   +---+   +   +   +   +   +   +
|   |   |   |   |   |       |   |   |                       |   |
+   +   +   +   +   +   +---+   +   +---+   +---+---+   +   +   +
|   |   |   |   |   |   |   |   |   |               |   |       |
+   +---+   +   +---+   +---+   +   +---+---+---+   +---+   +   +
|   |           |               |               |       |   |   |
+   +---+---+---+   +---+---+   +---+---+---+   +   +   +   +   +
|   |   |                   |                   |   |   |   |   |
+   +   +   +---+---+   +---+---+---+---+---+---+---+   +   +   +
|   |   |   |                           |   |   |   |   |   |   |
+   +   +   +   +---+---+---+---+---+---+   +   +   +   +   +   +
|       |   |                                           |   |   |
+   +   +   +---+---+---+---+---+---+   +   +   +   +   +   +   +
|   |   |           |       |       |   |   |   |   |   |   |   |
+   +   +---+   +---+---+   +   +   +---+---+---+   +   +   +   +
|   |   |   |           |   |       |               |   |   |   |
+   +   +   +---+   +---+   +---+   +   +---+---+---+   +   +   +
|   |   |       |       |       |                       |   |   |
+---+   +   +   +---+   +   +   +---+---+---+---+---+   +   +   +
|   |   |   |       |       |                   |   |   |   |   |
+   +   +   +---+   +---+   +---+   +---+   +   +   +---+   +   +
|   |       |   |   |   |       |       |   |   |       |   |   |
+   +   +   +---+   +   +---+   +---+   +---+   +   +   +   +   +
|   |   |   |   |           |       |       |       |   |   |   |
+   +---+   +   +   +   +---+---+   +---+   +---+---+   +   +   +
|   |   |           |       |           |                   |   |
+   +   +   +   +   +   +   +   +---+   +---+---+---+---+---+   +
|           |   |   |   |   |                               |   |
+   +   +   +---+---+   +---+---+   +---+---+---+   +---+   +   +
|   |   |   |                               |                   |
+---+---+---+---+---+---+---+---+---+---+---+---+---+---+---+---+
