+---+---+---+---+---+---+---+---+---+---+---+---+---+---+---+---+
|                                                               |
+   +---+---+---+---+---+---+---+---+---+---+---+---+---+   +---+
|   |           |           |           |                       |
+   +   +---+   +   +---+   +---+   +   +---+   +---+---+   +   +
|   |       |   |   |           |   |       |           |   |   |
+   +---+   +   +   +---+   +   +   +---+   +---+   +---+---+---+
|   |       |   |       |   |   |   |               |       |   |
+   +   +---+   +---+   +---+   +   +---+   +---+---+---+   +   +
|   |   |               |       |       |   |       |           |
+   +   +---+---+---+---+   +---+---+   +---+   +   +   +   +   +
|   |           |       |                   |   |       |   |   |
+   +---+---+   +   +   +---+---+---+---+---+   +---+---+---+   +
|   |   |   |       |   |               |       |           |   |
+   +   +   +---+---+   +   +---+---+   +   +---+   +---+   +   +
|   |           |   |   |   |       |   |   |       |       |   |
+   +   +   +---+   +   +   +   +   +   +   +   +---+   +---+   +
|   |   |   |           |   |       |   |   |   |           |   |
+   +   +   +   +---+---+   +   +---+   +   +   +   +   +---+   +
|   |   |       |       |           |   |       |   |   |   |   |
+   +   +---+---+   +   +   +---+---+   +---+---+   +---+   +   +
|   |   |       |   |       |       |           |           |   |
+   +   +   +   +   +---+---+   +   +---+---+   +---+---+   +   +
|   |   |   |           |       |                   |   |   |   |
+   +   +   +   +   +---+   +---+---+---+---+   +---+   +   +   +
|   |       |   |   |       |           |   |   |   |   |   |   |
+   +---+---+---+---+---+   +   +---+   +   +---+   +   +   +   +
|       |                   |       |           |           |   |
+   +   +   +---+---+---+---+---+   +---+   +   +   +   +   +   +
|   |   |                               |   |       |   |   |   |
+   +   +---+---+---+---+---+---+---+---+---+---+---+---+---+   +
|   |                                                           |
+---+---+---+---+---+---+---+---+---+---+---+---+---+---+---+---+
