+---+---+---+---+---+---+---+---+---+---+---+---+---+---+---+---+
|                   |               |                   |       |
+   +---+---+---+   +---+   +---+   +   +   +---+---+---+   +   +
|               |       |       |   |   |                   |   |
+   +---+---+   +---+   +   +   +   +---+---+---+---+---+---+   +
|           |   |   |   |   |   |       |                   |   |
+---+---+   +   +   +   +---+   +---+   +   +---+---+---+   +   +
|       |   |   |   |   |       |   |       |   |           |   |
+   +   +   +   +   +   +   +---+   +---+---+   +   +---+---+   +
|   |       |   |   |       |               |       |           |
+   +---+---+   +   +---+---+   +   +---+   +   +---+   +---+   +
|   |       |   |               |       |   |   |       |       |
+   +---+   +   +---+---+   +---+---+   +   +   +   +   +---+---+
|           |           |           |   |   |   |   |           |
+---+---+   +---+---+   +   +---+---+   +---+   +---+---+---+   +
|       |   |   |       |   |               |   |               |
+---+   +   +   +   +---+   +   +   +---+   +   +   +---+---+   +
|       |   |   |   |   |   |       |       |       |   |       |
+   +---+   +   +   +   +   +---+---+   +   +---+---+   +   +---+
|   |           |   |           |       |   |               |   |
+   +   +---+---+   +   +---+---+   +---+   +   +---+---+---+   +
|   |       |       |   |   |       |       |       |           |
+   +---+   +   +---+   +   +   +---+---+---+---+   +---+---+   +
|           |       |   |   |           |       |               |
+   +---+---+---+   +   +   +---+---+   +   +   +---+---+---+   +
|   |   |           |   |   |           |   |       |           |
+   +   +   +---+---+   +   +   +   +---+   +---+   +   +---+---+
|       |           |       |   |   |       |   |       |       |
+---+   +---+---+   +---+   +   +---+   +---+   +---+---+---+   +
|               |   |       |           |                   |   |
+---+---+---+---+   +   +---+---+---+---+   +---+---+---+   +   +
|                   |                       |                   |
+---+---+---+---+---+---+---+---+---+---+---+---+---+---+---+---+
