+---+---+---+---+---+---+---+---+---+---+---+---+---+---+---+---+
|                                                               |
+   +---+   +---+   +   +---+   +---+---+   +---+   +---+   +---+
|       |   |   |   |   |   |       |       |                   |
+   +---+   +   +   +   +   +   +   +   +---+   +---+   +---+   +
|   |       |   |   |       |   |           |                   |
+   +---+   +---+   +   +   +   +   +---+---+---+   +---+   +---+
|                       |           |                           |
+   +---+   +---+---+   +---+   +---+   +---+   +---+   +---+   +
|   |           |               |                               |
+   +   +   +   +   +---+   +---+   +---+   +---+   +---+   +---+
|       |   |               |                                   |
+---+   +   +   +---+   +---+   +---+   +---+   +---+   +---+   +
|   |                       |                                   |
+   +---+   +---+   +---+   +---+---+---+   +---+   +---+   +---+
|   |                       |       |   |                       |
+   +---+---+   +---+   +---+   +   +   +---+   +---+   +---+   +
|   |   |                   |           |                       |
+   +   +   +---+   +---+   +---+---+   +   +---+   +---+   +---+
|       |                   |           |                       |
+---+   +---+   +---+   +---+   +---+   +---+   +---+   +---+   +
|       |   |                   |       |                       |
+   +   +   +---+   +---+   +---+   +---+   +---+   +---+   +---+
|   |       |   |                       |                       |
+   +---+   +   +---+   +---+   +---+---+---+   +---+   +---+   +
|       |       |                   |                           |
+   +---+   +   +---+---+---+---+---+---+---+---+---+---+   +---+
|       |   |       |       |   |   |   |   |   |   |   |       |
+   +---+   +   +   +   +   +   +   +   +   +   +   +   +---+   +
|       |       |       |                                       |
+   +   +---+   +   +   +   +   +   +   +   +   +   +   +   +   +
|   |   |       |   |       |   |   |   |   |   |   |   |   |   |
+---+---+---+---+---+---+---+---+---+---+---+---+---+---+---+---+
