+---+---+---+---+---+---+---+---+---+---+---+---+---+---+---+---+
|   |                   |                                       |
+   +---+---+   +---+   +   +---+---+   +---+---+---+---+---+   +
|           |   |       |       |                           |   |
+   +---+   +   +   +---+   +   +   +---+---+---+---+   +   +   +
|       |   |   |   |       |   |               |       |       |
+   +   +   +   +   +---+   +   +   +---+   +   +   +---+---+   +
|   |   |       |       |   |   |           |           |       |
+---+   +---+   +---+   +---+   +   +---+   +   +---+---+   +   +
|       |   |   |       |       |                   |       |   |
+   +   +   +   +   +   +   +   +   +---+   +---+---+   +---+   +
|   |   |       |   |       |   |   |           |       |       |
+   +---+   +   +   +   +   +   +   +   +---+---+   +---+   +   +
|       |   |   |       |   |   |           |       |       |   |
+   +   +---+   +---+---+---+---+   +---+---+   +---+   +---+   +
|   |       |               |       |   |                       |
+---+---+   +---+   +---+   +   +   +   +   +---+---+   +---+---+
|       |       |           |       |               |   |       |
+   +   +---+   +---+   +   +---+---+---+---+---+   +---+   +   +
|   |       |       |   |       |                       |   |   |
+   +---+   +   +---+---+   +   +   +---+   +   +---+---+   +   +
|               |       |   |   |   |       |   |           |   |
+---+---+---+   +   +   +---+   +   +   +   +   +   +---+---+   +
|               |   |           |       |                   |   |
+   +---+---+   +   +   +---+---+---+   +---+   +---+   +   +   +
|               |   |   |   |   |   |       |           |   |   |
+   +---+   +---+   +   +   +   +   +---+   +---+---+   +---+   +
|       |   |       |                   |       |       |       |
+   +   +   +   +   +   +   +   +   +   +---+   +---+---+   +   +
|   |   |       |       |   |   |   |       |               |   |
+   +   +---+---+---+---+---+---+   +---+   +---+---+---+---+   +
|   |                                                           |
+---+---+---+---+---+---+---+---+---+---+---+---+---+---+---+---+
